1111111111111111111111111111111111111111111111111111111111111111
1111111111111111111111111111111111111111111111111111111111111111
1111111111111111110000000000000000000000111111111000000000000111
1111111111111111102222222222222222222222011111110222222222222011
1111111111111111101111111111111111111111011111110222222222222201
1111111111111111102222222222222222222222011111102222222222222201
1111111111111111102222200000000000002222000000001111111111111101
1111111111111111102222201111111111102222111111111111111111111101
1111111111111111102222201111111111102222111111111111111111111101
1111111111111111102222201111111111102222111111111111111111111101
1111111111111111102222200000000000002222000000001111111111111101
1111111111111111102222222222222222222222011111101111111111111101
1111111111111111102222222222222222222222011111101111111111111101
1111111111111111110000000001100000000000111111110111111111111011
1111111111111111111100000001100001111111111111111000001100000111
1111111111111111111101111111111110111111111111111111101101111111
1111111111111111111101000000000010111111111111111111101101111111
1111111100000111111001001111110010011111100000111111101101111111
1111111011111011110111110111101111101111011111011110001100111111
1111110111111101101111111011011121210110111211101101221111011111
1111110121121101101111111011012121110110121121101101111111011111
1111110111111100001111111000012111110000111212100001112211011111
1111110111111111111111111111111111211111111211111111111111011111
1111110111211100001111111000011122110000111111100002111211011111
1111110112221101101111111011011211120110111211101101112111011111
1111110211111101101111111011012111210110112112101101112111011111
1111111011121011110111110111101121101111011121011110000000111111
1111111100000111111011101111110000011111100000111111111111111111
1111111111111111111111111111111111111111111111111111111111111111
1111111111111111111111111111111111111111111111111111111111111111
1111111111111111111111111111111111111111111111111111111111111111
1111111111111111111111111111111111111111111111111111111111111111
1111111111111111111111111111111111111111111111111111111111111111
1111111111111111111111111111111111111111111111111111111111111111
1111111111111111111111111111111111111111111111111111111111111111
1111111111111111111111111111111111111111111111111111111111111111
1111111111111111111111111111111111111111111111111111111111111111
1111111111111111111111111111111111111111111111111111111111111111
1111111111111111111111111111111111111111111111111111111111111111
1111111111111111111111111111111111111111111111111111111111111111
1111111111111111111111111111111111111111111111111111111111111111
1111111111111111111111111111111111111111111111111111111111111111
1111111111111111111111111111111111111111111111111111111111111111
1111111111111111111111111111111111111111111111111111111111111111
1111111111111111111111111111111111111111111111111111111111111111
1111111111111111111111111111111111111111111111111111111111111111
1111111111111111111111111111111111111111111111111111111111111111
1111111111111111111111111111111111111111111111111111111111111111
1111111111111111111111111111111111111111111111111111111111111111
1111111111111111111111111111111111111111111111111111111111111111
1111111111111111111111111111111111111111111111111111111111111111
1111111111111111111111111111111111111111111111111111111111111111
1111111111111111111111111111111111111111111111111111111111111111
1111111111111111111111111111111111111111111111111111111111111111
1111111111111111111111111111111111111111111111111111111111111111
1111111111111111111111111111111111111111111111111111111111111111
1111111111111111111111111111111111111111111111111111111111111111
1111111111111111111111111111111111111111111111111111111111111111
1111111111111111111111111111111111111111111111111111111111111111
1111111111111111111111111111111111111111111111111111111111111111
1111111111111111111111111111111111111111111111111111111111111111
1111111111111111111111111111111111111111111111111111111111111111
1111111111111111111111111111111111111111111111111111111111111111
1111111111111111111111111111111111111111111111111111111111111111