000000000000000000000000000000000000000000000000000000000000000
000000000000000000000000000000000000000000000000000000000000000
001111222222222222211111111111100000000000000000111111122222200
001222221111112222221111111111102222222222222220111111111122200
001222221111112222222222222111102112222111222120111111111122100
002222111111222222222211111111102211222111122220111111111112100
001211111111122222222222222211102112111121221120111122222211200
001111222222222111111111111111102222222002222210111122222222200
001111111111122222222222111111100000001111000000111112222211100
001222211111111222222222211111111111111111111111222221111111100
002222222222222221111111111111111111111111111111111112221111100
001111111111111111111111111111111111111111111222222222212222200
001111111111111111111111111111111111111111111111111122222111100
001111111111111111111111111111111111111111111222222222111111100
001111111111111111111111111111111111111112222222222211111111100
001111111111122111111111111111111111122222222111111111122111100
001111111111102211111111111111111111111111111111111222222211100
001111111111102211111222222222221111112222221111111211222222200
001111111111110221111111111111111111222222222221111112222222100
001111111111110221112222222111111111121111111122222221222111100
001111111111111022111222222222222222222222222222222222111111100
001111111111111000000000000000000000000000000000000000000000000
001111111111111222222222211111111111122222211112222222111222200
001111111111111111122221111122222222211111112222222211122211200
001111111111111111111111111111111111111111111111111111111111100
001111111111111111111111111111111111111111111111111111111111100
001111111111111111111111111111111111111111111111111111111111100
002111122222222222111111111111111111111112222121111222211111100
002221222222111222222222221111111111222222111111222222222222100
000212002120021200212002120021111120021200212002120021200211000
000000000000000000000000000001111100000000000000000000000000000
000000000000000000000000000001111100000000000000000000000000000
000000000000000000000000000011111110000000000000000000000000000
001111111111111111111111111111111111111111111111111111111111100
001111111111111111111111111111111111111111111111111111111111100
001111111111111111111111111111111111111111111111111111111111100
001111111111111111111111111111111111100000000000000111111111100
001111111111111111111111111111111111031111111111111011111111100
001111111111111111111111111111111111011111111111111011111111100
001111111111111111111111111111111111011111101111111011111111100
001111111111111111111111111111111111000000001111111011111111100
001111111111111111111111111111111111111111101111111011111111100
001111111111111111111111111111111111111111101111111011111111100
001111111111111111111111111111111111111111111111111011111111100
001111111111111111111111111111111111111111111111111011111111100
001111111111111111111111111111111111111111101111111011111111100
001111111111111111111111111111111111111111101111111011111111100
001111111111111111111111111111111111111111110000000111111111100
001111111111111111111111111111111111111111111111111111111111100
001111111111111111111111111111111111111111111111111111111111100
001111111111111111111111111111111111111111111111111111111111100
001111111111111111111111111111111111111111111111111111111111100
001111111111111111111111111111111111111111111111111111111111100
001111111111111111111111111200212002111111111111111111111111100
001111111111111111111111111011111110111111111111111111111111100
001111111111111111111111111011111110111111111111111111111111100
001111111111111111111111111011111110111111111111111111111111100
001111111111111111111111111011111110111111111111111111111111100
001111111111111111111111111011111110111111111111111111111111100
001111111111111111111111111100000001111111111111111111111111100
001111111111111111111111111111111111111111111111111111111111100
001111111111111111111111111111111111111111111111111111111111100
000000000000000000000000000000000000000000000000000000000000000
000000000000000000000000000000000000000000000000000000000000000